name,state_name,early_career_pay,mid_career_pay,make_world_better_percent,stem_percent,type,degree_length,room_and_board,in_state_tuition,in_state_total,out_of_state_tuition,out_of_state_total
Auburn University,Alabama,54400,104500,51,31,Public,4 Year,13332,11276,24608,30524,43856
University of Alabama in Huntsville,Alabama,57500,103900,59,45,Public,4 Year,10094,10714,20808,22362,32456
Tuskegee University,Alabama,54500,93500,61,30,Private,4 Year,9650,22170,31820,22170,31820
Samford University,Alabama,48400,90500,52,3,Private,4 Year,10550,31650,42200,31650,42200
Spring Hill College,Alabama,46600,89100,53,12,Private,4 Year,13462,39464,52926,39464,52926
Birmingham Southern College,Alabama,49100,88300,48,27,Private,4 Year,12350,17650,30000,17650,30000
University of Alabama at Birmingham,Alabama,48600,87200,57,17,Public,4 Year,6400,10710,17110,24630,31030
University of South Alabama,Alabama,47700,86400,56,17,Public,4 Year,9200,10370,19570,18680,27880
University of South Alabama,Alabama,47700,86400,56,17,Public,4 Year,7620,9870,17490,19740,27360
Troy University,Alabama,44500,81500,60,8,Public,4 Year,8185,12460,20645,22875,31060
Jacksonville State University,Alabama,43800,80000,61,7,Public,4 Year,8100,10425,18525,20145,28245
Auburn University at Montgomery,Alabama,45000,79600,61,12,Public,4 Year,6980,10288,17268,22048,29028
Huntingdon College,Alabama,42400,78900,69,14,Private,4 Year,9750,27400,37150,27400,37150
Oakwood University,Alabama,43500,78800,71,16,Private,4 Year,9312,16720,26032,16720,26032
University of West Alabama,Alabama,42700,76100,61,4,Public,4 Year,8116,10040,18156,18490,26606
University of North Alabama,Alabama,43000,75600,61,6,Public,4 Year,9200,10370,19570,18680,27880
University of North Alabama,Alabama,43000,75600,61,6,Public,4 Year,7620,9870,17490,19740,27360
University of Mobile,Alabama,40600,74100,77,7,Private,4 Year,9600,22820,32420,22820,32420
Alabama State University,Alabama,39800,71500,61,16,Public,4 Year,5422,11068,16490,19396,24818
Faulkner University,Alabama,39400,71300,61,2,Private,4 Year,7750,21690,29440,21690,29440
University of Montevallo,Alabama,38900,70700,49,7,Public,4 Year,9330,12760,22090,25780,35110
Judson College,Alabama,37900,67600,65,13,Private,4 Year,10590,18510,29100,18510,29100
Miles College,Alabama,34800,65100,64,19,Private,4 Year,7042,11604,18646,11604,18646
University of Alaska Fairbanks,Alaska,59100,101800,54,20,Public,4 Year,8930,8087,17017,24257,33187
University of Alaska Anchorage,Alaska,56000,101000,57,10,Public,4 Year,12200,7688,19888,23858,36058
Alaska Pacific University,Alaska,50300,90000,67,6,Private,4 Year,7300,20830,28130,20830,28130
University of Arizona,Arizona,56100,101000,51,23,Public,4 Year,12550,12487,25037,36386,48936
Northern Arizona University,Arizona,49600,90000,56,12,Public,4 Year,10282,11564,21846,25828,36110
Prescott College,Arizona,41200,73500,69,0,Private,4 Year,7700,31485,39185,31485,39185
University of Arkansas,Arkansas,52500,98000,49,18,Public,4 Year,11020,9130,20150,25168,36188
Hendrix College,Arkansas,48100,90300,58,33,Private,4 Year,12284,45790,58074,45790,58074
Harding University,Arkansas,49200,88600,47,10,Private,4 Year,7044,20135,27179,20135,27179
John Brown University,Arkansas,47000,82700,53,9,Private,4 Year,9224,26928,36152,26928,36152
University of Arkansas at Little Rock,Arkansas,45600,80800,55,13,Public,4 Year,8930,8966,17896,21206,30136
Ouachita Baptist University,Arkansas,44100,80200,58,18,Private,4 Year,7880,26790,34670,26790,34670
Henderson State University,Arkansas,42900,79800,57,5,Public,4 Year,7504,8436,15940,10086,17590
University of Central Arkansas,Arkansas,44900,79800,52,8,Public,4 Year,6854,8751,15605,15274,22128
University of Arkansas at Monticello,Arkansas,43500,78300,61,2,Public,4 Year,6824,7696,14520,13546,20370
Arkansas Tech University,Arkansas,45000,76900,54,7,Public,4 Year,7870,9068,16938,15848,23718
University of the Ozarks,Arkansas,42300,74500,58,16,Private,4 Year,7400,24230,31630,24230,31630
Lyon College,Arkansas,41200,74300,53,33,Private,4 Year,9130,28790,37920,28790,37920
University of Arkansas at Pine Bluff,Arkansas,40500,70500,67,22,Public,4 Year,7881,7842,15723,14094,21975
Harvey Mudd College,California,88800,158200,55,85,Private,4 Year,18127,56876,75003,56876,75003
California Institute of Technology,California,84100,151600,53,97,Private,4 Year,15525,52362,67887,52362,67887
Stanford University,California,79000,145200,56,51,Private,4 Year,15763,51354,67117,51354,67117
Santa Clara University,California,69900,134700,44,29,Private,4 Year,14910,51711,66621,51711,66621
University of California-Berkeley,California,70700,131800,49,36,Public,4 Year,16160,14184,30344,43176,59336
Claremont McKenna College,California,68500,125400,43,16,Private,4 Year,16705,54405,71110,54405,71110
University of California-San Diego,California,63400,123700,52,58,Public,4 Year,12362,14199,26561,43191,55553
University of Southern California,California,64500,120600,47,23,Private,4 Year,15395,56225,71620,56225,71620
California Polytechnic State University-San Luis Obispo,California,65600,119500,51,38,Public,4 Year,13796,9816,23612,21696,35492
Pomona College,California,63800,117200,47,37,Private,4 Year,16716,52780,69496,52780,69496
University of California-Santa Barbara,California,59700,116300,47,29,Public,4 Year,15273,14424,29697,43416,58689
University of California-Los Angeles,California,62000,116100,48,31,Public,4 Year,15816,13774,29590,42766,58582
University of California-Irvine,California,59600,116000,49,34,Public,4 Year,15263,15614,30877,44606,59869
San Jose State University,California,63000,114700,53,28,Public,4 Year,16442,7796,24238,17300,33742
Loyola Marymount University,California,58500,113300,39,9,Private,4 Year,14490,48522,63012,48522,63012
University of California-Davis,California,61500,112600,52,35,Public,4 Year,16211,14463,30674,43458,59669
Menlo College,California,61900,112400,59,0,Private,4 Year,14225,42800,57025,42800,57025
California State Polytechnic University-Pomona,California,57700,110800,50,30,Public,4 Year,17358,7353,24711,19233,36591
Saint Mary's College of California,California,59900,110800,51,5,Private,4 Year,15370,47280,62650,47280,62650
University of San Francisco,California,60600,109900,52,6,Private,4 Year,14830,48066,62896,48066,62896
University of San Diego,California,58900,109400,48,12,Private,4 Year,12980,49358,62338,49358,62338
Colorado School of Mines,Colorado,75600,139600,60,93,Public,4 Year,13169,18964,32133,38584,51753
University of Colorado Boulder,Colorado,57800,109900,48,39,Public,4 Year,14418,12532,26950,37286,51704
University of Denver,Colorado,55700,105100,48,12,Private,4 Year,13005,50556,63561,50556,63561
Colorado College,Colorado,53100,97900,48,23,Private,4 Year,12512,55470,67982,55470,67982
Regis University,Colorado,55500,94800,58,13,Private,4 Year,11560,36810,48370,36810,48370
University of Colorado Colorado Springs,Colorado,52200,90900,53,21,Public,4 Year,10500,10463,20963,24893,35393
Colorado State University-Pueblo,Colorado,48100,87600,62,13,Public,4 Year,10470,10408,20878,26329,36799
University of Northern Colorado,Colorado,47700,87100,52,7,Public,4 Year,11204,9786,20990,21474,32678
Fort Lewis College,Colorado,48300,82600,55,19,Public,4 Year,9878,9040,18918,19696,29574
Western State Colorado University,Colorado,44800,81500,47,19,Public,4 Year,9635,10114,19749,21586,31221
Colorado Mesa University,Colorado,47800,81500,55,7,Public,4 Year,10925,9243,20168,22440,33365
Adams State University,Colorado,44400,81400,56,3,Public,4 Year,8782,9440,18222,20456,29238
Colorado Christian University,Colorado,46800,80100,70,2,Private,4 Year,11846,31866,43712,31866,43712
Johnson & Wales University-Denver,Colorado,41500,74800,39,0,Private,4 Year,12546,32091,44637,32091,44637
Yale University,Connecticut,70300,138300,53,22,Private,4 Year,16000,53430,69430,53430,69430
Wesleyan University,Connecticut,61600,117000,53,21,Private,4 Year,15060,54914,69974,54914,69974
Fairfield University,Connecticut,62300,116900,41,17,Private,4 Year,14710,48350,63060,48350,63060
Trinity College,Connecticut,60100,110900,49,22,Private,4 Year,14750,56910,71660,56910,71660
University of Connecticut,Connecticut,59100,105200,48,24,Public,4 Year,12874,15730,28604,38098,50972
University of Hartford,Connecticut,55200,101600,53,15,Private,4 Year,12476,40694,53170,40694,53170
Connecticut College,Connecticut,57500,100800,36,30,Private,4 Year,15150,54820,69970,54820,69970
Sacred Heart University,Connecticut,55000,100500,46,15,Private,4 Year,15310,41420,56730,41420,56730
Quinnipiac University,Connecticut,55900,97700,46,10,Private,4 Year,14540,47960,62500,47960,62500
University of New Haven,Connecticut,52100,94800,52,25,Private,4 Year,15900,39270,55170,39270,55170
Central Connecticut State University,Connecticut,53100,93700,45,15,Public,4 Year,12176,10616,22792,21856,34032
University of Bridgeport,Connecticut,49900,93600,59,31,Private,4 Year,13860,32850,46710,32850,46710
University of Saint Joseph,Connecticut,49900,88800,63,9,Private,4 Year,11428,39173,50601,39173,50601
Western Connecticut State University,Connecticut,51700,88100,50,6,Public,4 Year,13560,11356,24916,22596,36156
Western Connecticut State University,Connecticut,51700,88100,50,6,Public,4 Year,13072,10819,23891,22059,35131
Eastern Connecticut State University,Connecticut,49200,87800,43,14,Public,4 Year,13560,11356,24916,22596,36156
Eastern Connecticut State University,Connecticut,49200,87800,43,14,Public,4 Year,13072,10819,23891,22059,35131
Albertus Magnus College,Connecticut,49700,85900,62,2,Private,4 Year,13200,32060,45260,32060,45260
Southern Connecticut State University,Connecticut,48500,83600,51,6,Public,4 Year,12860,10875,23735,22115,34975
University of Delaware,Delaware,58600,105400,43,22,Public,4 Year,12862,13680,26542,34310,47172
Goldey-Beacom College,Delaware,49800,86900,42,25,Private,4 Year,6400,24300,30700,24300,30700
Delaware State University,Delaware,46300,81900,62,10,Public,4 Year,12190,7868,20058,16904,29094
Wesley College,Delaware,45400,77300,50,2,Private,4 Year,11717,26406,38123,26406,38123
Florida Institute of Technology,Florida,58300,105400,53,48,Private,4 Year,12880,41850,54730,41850,54730
University of Florida,Florida,55800,102800,52,29,Public,4 Year,10120,6381,16501,28658,38778
University of Miami,Florida,56200,99600,48,22,Private,4 Year,14108,50226,64334,50226,64334
Florida State University,Florida,50800,92700,49,18,Public,4 Year,10816,6516,17332,21683,32499
Florida Atlantic University,Florida,49400,91200,51,15,Public,4 Year,11896,6039,17935,21595,33491
Jacksonville University,Florida,50100,90400,66,5,Private,4 Year,14080,36670,50750,36670,50750
Florida International University,Florida,49600,90100,51,16,Public,4 Year,10882,6558,17440,18956,29838
Adventist University of Health Sciences,Florida,51600,89800,88,5,Private,4 Year,4200,15150,19350,15150,19350
Nova Southeastern University,Florida,50200,89800,60,9,Private,4 Year,13250,30900,44150,30900,44150
University of Central Florida,Florida,49700,88600,50,16,Public,4 Year,9617,6368,15985,22467,32084
Eckerd College,Florida,49200,88400,52,25,Private,4 Year,12588,44540,57128,44540,57128
Rollins College,Florida,49000,87000,53,7,Private,4 Year,14735,49760,64495,49760,64495
University of North Florida,Florida,48800,86600,51,11,Public,4 Year,9976,6394,16370,20112,30088
University of North Florida,Florida,48800,86600,51,11,Public,4 Year,11610,6410,18020,17324,28934
New College of Florida,Florida,47300,86500,40,4,Public,4 Year,9264,6919,16183,29944,39208
Stetson University,Florida,47000,86000,44,7,Private,4 Year,13052,46030,59082,46030,59082
Lynn University,Florida,46100,85000,45,2,Private,4 Year,12170,38210,50380,38210,50380
Barry University,Florida,47400,84400,66,12,Private,4 Year,11100,29850,40950,29850,40950
Florida Agricultural and Mechanical University,Florida,48000,83900,62,8,Public,4 Year,10594,5827,16421,17768,28362
Emory University,Georgia,62000,110800,44,20,Private,4 Year,14456,51306,65762,51306,65762
University of Georgia,Georgia,54400,100700,45,14,Public,4 Year,10038,11830,21868,30404,40442
Morehouse College,Georgia,55700,98700,58,26,Private,4 Year,13438,27574,41012,27574,41012
Kennesaw State University,Georgia,52500,94600,46,22,Public,4 Year,11467,7432,18899,21158,32625
Oglethorpe University,Georgia,52400,91400,50,12,Private,4 Year,13200,38100,51300,38100,51300
Georgia State University,Georgia,50600,90800,47,18,Public,4 Year,11378,10858,22236,29432,40810
Georgia Southern University,Georgia,49000,88000,49,17,Public,4 Year,10070,7422,17492,20904,30974
University of North Georgia,Georgia,47300,85600,51,8,Public,4 Year,7876,7336,15212,21148,29024
Spelman College,Georgia,50200,85400,52,24,Private,4 Year,13865,29314,43179,29314,43179
Mercer University,Georgia,48500,85100,62,14,Private,4 Year,11616,36894,48510,36894,48510
Berry College,Georgia,44900,84900,44,21,Private,4 Year,12770,36556,49326,36556,49326
Augusta University,Georgia,47000,84400,69,10,Public,4 Year,9640,10758,20398,29796,39436
Agnes Scott College,Georgia,46000,83600,57,26,Private,4 Year,12330,41160,53490,41160,53490
University of West Georgia,Georgia,46700,82700,51,9,Public,4 Year,10918,7292,18210,20774,31692
Armstrong State University,Georgia,46600,81500,60,10,Public,4 Year,11385,6384,17769,19866,31251
Clayton  State University,Georgia,46400,81200,54,9,Public,4 Year,9994,6410,16404,19486,29480
Clark Atlanta University,Georgia,46300,81100,54,15,Private,4 Year,9524,23436,32960,23436,32960
Valdosta State University,Georgia,43400,81000,57,7,Public,4 Year,8110,7476,15586,20958,29068
Savannah College of Art and Design,Georgia,46800,80100,34,3,Private,4 Year,14550,36630,51180,36630,51180
Shorter University,Georgia,45600,79900,55,6,Private,4 Year,9400,22370,31770,22370,31770
Middle Georgia State University,Georgia,44000,79800,57,11,Public,4 Year,9080,4608,13688,13568,22648
Covenant College,Georgia,44400,79400,62,19,Private,4 Year,10260,34330,44590,34330,44590
Columbus State University,Georgia,43300,77900,59,10,Public,4 Year,9880,7200,17080,20682,30562
Brigham Young University-Hawaii,Hawaii,51700,93900,57,12,Private,4 Year,6586,5560,12146,5560,12146
Hawaii Pacific University,Hawaii,52200,93500,56,15,Private,4 Year,14800,25980,40780,25980,40780
University of Hawaii at Manoa,Hawaii,51600,91600,56,18,Public,4 Year,13689,11970,25659,34002,47691
Chaminade University of Honolulu,Hawaii,45400,84000,55,3,Private,4 Year,13630,25374,39004,25374,39004
University of Hawaii at Hilo,Hawaii,44000,77200,59,14,Public,4 Year,11406,7720,19126,20680,32086
University of Idaho,Idaho,52300,97700,54,22,Public,4 Year,8880,7864,16744,25500,34380
Brigham Young University-Idaho,Idaho,53700,93500,59,14,Private,4 Year,4592,4118,8710,4118,8710
Idaho State University,Idaho,50800,91800,64,12,Public,4 Year,7207,7420,14627,22940,30147
Boise State University,Idaho,50100,86400,55,14,Public,4 Year,10692,7694,18386,23776,34468
Northwest Nazarene University,Idaho,46200,80600,68,7,Private,4 Year,7400,29300,36700,29300,36700
Lewis-Clark State College,Idaho,44900,77600,60,5,Public,4 Year,7580,6618,14198,19236,26816
Illinois Institute of Technology,Illinois,64600,118500,47,64,Private,4 Year,12762,47296,60058,47296,60058
Northwestern University,Illinois,63400,115400,46,20,Private,4 Year,16626,54567,71193,54567,71193
University of Illinois at Urbana-Champaign,Illinois,62600,115300,44,36,Public,4 Year,11308,15094,26402,31664,42972
University of Chicago,Illinois,64000,114200,41,22,Private,4 Year,16350,58230,74580,58230,74580
Bradley University,Illinois,55600,104900,46,38,Private,4 Year,10620,33760,44380,33760,44380
University of Illinois at Chicago,Illinois,56300,103800,48,31,Public,4 Year,12074,13764,25838,26980,39054
DePaul University,Illinois,55700,102900,43,15,Private,4 Year,14235,39975,54210,39975,54210
Lake Forest College,Illinois,55400,102600,46,21,Private,4 Year,10390,47064,57454,47064,57454
Illinois Wesleyan University,Illinois,53100,96000,44,18,Private,4 Year,10984,47636,58620,47636,58620
Loyola University Chicago,Illinois,53400,96000,45,15,Private,4 Year,14480,44048,58528,44048,58528
Northern Illinois University,Illinois,53000,95500,47,20,Public,4 Year,10880,12262,23142,12262,23142
Knox College,Illinois,50600,95400,45,24,Private,4 Year,9870,46554,56424,46554,56424
Illinois State University,Illinois,51200,95000,47,10,Public,4 Year,9850,14516,24366,26040,35890
Principia College,Illinois,52600,94900,56,19,Private,4 Year,11610,29470,41080,29470,41080
North Central College,Illinois,50400,92900,45,9,Private,4 Year,11019,38880,49899,38880,49899
Saint Xavier University,Illinois,49400,91200,60,10,Private,4 Year,11340,33880,45220,33880,45220
Southern Illinois University-Carbondale,Illinois,49700,90900,54,17,Public,4 Year,10622,14704,25326,14704,25326
Southern Illinois University-Edwardsville,Illinois,51400,90100,50,21,Public,4 Year,11121,12132,23253,25817,36938
Lewis University,Illinois,49700,89800,53,14,Private,4 Year,10578,32450,43028,32450,43028
Rose-Hulman Institute of Technology,Indiana,75000,135800,51,96,Private,4 Year,14766,49871,64637,49871,64637
University of Notre Dame,Indiana,67000,130500,45,28,Private,4 Year,15410,53391,68801,53391,68801
Wabash College,Indiana,62200,114400,40,34,Private,4 Year,10050,43450,53500,43450,53500
DePauw University,Indiana,56600,101000,47,24,Private,4 Year,13020,49704,62724,49704,62724
Trine University,Indiana,55100,100300,56,26,Private,4 Year,10810,32175,42985,32175,42985
Butler University,Indiana,51800,99300,53,9,Private,4 Year,13830,41120,54950,41120,54950
Valparaiso University,Indiana,53300,98000,52,31,Private,4 Year,11860,40260,52120,40260,52120
Indiana University-Bloomington,Indiana,53600,97100,47,16,Public,4 Year,10465,10681,21146,35456,45921
Taylor University,Indiana,48700,90600,59,16,Private,4 Year,9614,34114,43728,34114,43728
University of Evansville,Indiana,50300,89900,54,17,Private,4 Year,12460,36416,48876,36416,48876
Saint Mary's College,Indiana,49700,89300,54,15,Private,4 Year,12580,42220,54800,42220,54800
Earlham College,Indiana,49100,88400,57,31,Private,4 Year,10400,46450,56850,46450,56850
Indiana University-Purdue University-Indianapolis,Indiana,50500,88200,55,15,Public,4 Year,8924,9465,18389,29821,38745
Franklin College,Indiana,48900,86200,45,21,Private,4 Year,9946,32010,41956,32010,41956
Indiana State University,Indiana,47900,85600,55,8,Public,4 Year,10590,9090,19680,19836,30426
Hanover College,Indiana,47500,85100,53,24,Private,4 Year,11580,37670,49250,37670,49250
Indiana Institute of Technology,Indiana,50000,84900,46,11,Private,4 Year,10020,26900,36920,26900,36920
Manchester University,Indiana,46900,84700,56,10,Private,4 Year,9580,32758,42338,32758,42338
University of Indianapolis,Indiana,47300,84500,55,5,Private,4 Year,10288,29688,39976,29688,39976
Ball State University,Indiana,45600,83700,48,7,Public,4 Year,10234,9896,20130,26468,36702
Indiana University-Purdue University-Fort Wayne,Indiana,47300,83200,52,17,Public,4 Year,5996,8450,14446,20288,26284
Iowa State University,Iowa,56100,101300,48,31,Public,4 Year,8720,8988,17708,23392,32112
Drake University,Iowa,52800,99900,49,7,Private,4 Year,10528,41396,51924,41396,51924
University of Iowa,Iowa,54100,99400,48,16,Public,4 Year,11172,9267,20439,31233,42405
Grinnell College,Iowa,53400,96500,49,41,Private,4 Year,12810,52392,65202,52392,65202
Cornell College,Iowa,49600,90600,47,22,Private,4 Year,9384,42299,51683,42299,51683
Loras College,Iowa,48000,90100,56,14,Private,4 Year,8275,34184,42459,34184,42459
Dordt College,Iowa,51000,89600,57,17,Private,4 Year,9590,30870,40460,30870,40460
Central College,Iowa,49000,88800,55,36,Private,4 Year,10280,37295,47575,37295,47575
Simpson College,Iowa,49900,88600,47,17,Private,4 Year,8380,39144,47524,39144,47524
Wartburg College,Iowa,49300,88000,49,34,Private,4 Year,9996,41280,51276,41280,51276
Coe College,Iowa,47200,86900,41,24,Private,4 Year,9480,45000,54480,45000,54480
Luther College,Iowa,48200,85900,49,21,Private,4 Year,9460,42290,51750,42290,51750
University of Northern Iowa,Iowa,47100,85300,46,8,Public,4 Year,8948,8938,17886,19480,28428
Northwestern College,Iowa,44800,82400,42,11,Private,4 Year,9200,31100,40300,31100,40300
Morningside College,Iowa,44900,82100,60,6,Private,4 Year,9610,31530,41140,31530,41140
Clarke University,Iowa,44900,80200,52,6,Private,4 Year,9600,33350,42950,33350,42950
University of Dubuque,Iowa,44200,79700,48,7,Private,4 Year,9930,34110,44040,34110,44040
Mount Mercy University,Iowa,47200,79000,51,4,Private,4 Year,9534,31798,41332,31798,41332
William Penn University,Iowa,43900,78300,59,7,Private,4 Year,6952,25600,32552,25600,32552
Upper Iowa University,Iowa,44200,78000,56,3,Private,4 Year,8454,30450,38904,30450,38904
University of Kansas,Kansas,53000,98600,52,16,Public,4 Year,10350,11148,21498,27358,37708
Kansas State University,Kansas,52500,97200,51,18,Public,4 Year,9680,10263,19943,25767,35447
Benedictine College,Kansas,48700,91800,69,13,Private,4 Year,10300,29530,39830,29530,39830
Newman University,Kansas,48000,88500,66,11,Private,4 Year,8326,30724,39050,30724,39050
Wichita State University,Kansas,48700,87300,57,24,Public,4 Year,11252,8271,19523,17452,28704
Pittsburg State University,Kansas,47100,84900,51,8,Public,4 Year,7778,7298,15076,18642,26420
Baker University,Kansas,47800,84200,55,2,Private,4 Year,8410,29830,38240,29830,38240
Washburn University,Kansas,47000,83000,54,4,Public,4 Year,8237,8870,17107,19940,28177
McPherson College,Kansas,44500,80900,59,9,Private,4 Year,8788,28951,37739,28951,37739
Kansas Wesleyan University,Kansas,44700,79400,61,10,Private,4 Year,9500,29500,39000,29500,39000
Fort Hays State University,Kansas,45100,79300,64,6,Public,4 Year,8300,5133,13433,15201,23501
Sterling College,Kansas,42700,79100,73,7,Private,4 Year,8280,26000,34280,26000,34280
MidAmerica Nazarene University,Kansas,46200,78500,60,1,Private,4 Year,8708,30736,39444,30736,39444
Emporia State University,Kansas,43500,78000,60,9,Public,4 Year,8912,6758,15670,20675,29587
Tabor College,Kansas,43300,77500,62,7,Private,4 Year,9850,28245,38095,28245,38095
Friends University,Kansas,44700,76500,59,14,Private,4 Year,7972,28415,36387,28415,36387
University of Kentucky,Kentucky,51700,96400,48,19,Public,4 Year,12982,12245,25227,29099,42081
Thomas More College,Kentucky,50000,90900,56,8,Private,4 Year,7950,31120,39070,31120,39070
Bellarmine University,Kentucky,49000,90700,54,11,Private,4 Year,12250,42200,54450,42200,54450
Centre College,Kentucky,49500,88500,52,22,Private,4 Year,10480,41700,52180,41700,52180
University of Louisville,Kentucky,49500,87600,50,18,Public,4 Year,9226,11656,20882,27278,36504
Northern Kentucky University,Kentucky,49000,87400,46,12,Public,4 Year,10022,10032,20054,19680,29702
Transylvania University,Kentucky,47900,85600,51,25,Private,4 Year,10460,38750,49210,38750,49210
Western Kentucky University,Kentucky,45500,83100,49,10,Public,4 Year,9018,9296,18314,19074,28092
Western Kentucky University,Kentucky,45500,83100,49,10,Public,4 Year,8343,10602,18945,26496,34839
Georgetown College,Kentucky,45000,81900,54,10,Private,4 Year,9780,38650,48430,38650,48430
Brescia University,Kentucky,44300,81200,53,7,Private,4 Year,9200,22400,31600,22400,31600
Eastern Kentucky University,Kentucky,45600,80700,56,5,Public,4 Year,9018,9296,18314,19074,28092
Eastern Kentucky University,Kentucky,45600,80700,56,5,Public,4 Year,8343,10602,18945,26496,34839
Murray State University,Kentucky,44800,79900,56,9,Public,4 Year,9190,9084,18274,24540,33730
Spalding University,Kentucky,44800,79200,71,0,Private,4 Year,7600,24500,32100,24500,32100
Kentucky Wesleyan College,Kentucky,42100,76800,65,14,Private,4 Year,9764,26440,36204,26440,36204
Morehead State University,Kentucky,41300,74900,56,9,Public,4 Year,9960,9170,19130,13646,23606
University of the Cumberlands,Kentucky,39800,73800,63,8,Private,4 Year,9000,23000,32000,23000,32000
Kentucky State University,Kentucky,40700,73100,57,13,Public,4 Year,6690,8090,14780,19390,26080
Berea College,Kentucky,39500,71600,53,27,Private,4 Year,6764,39990,46754,39990,46754
Asbury University,Kentucky,39400,70800,59,4,Private,4 Year,7160,30198,37358,30198,37358
University of Pikeville,Kentucky,39000,70700,74,11,Private,4 Year,7800,20950,28750,20950,28750
Kentucky Christian University,Kentucky,39600,70300,68,3,Private,4 Year,8270,19820,28090,19820,28090
Midway University,Kentucky,39200,70300,53,3,Private,4 Year,8480,24650,33130,24650,33130
Campbellsville University,Kentucky,37600,66800,50,7,Private,4 Year,8000,25400,33400,25400,33400
Lindsey Wilson College,Kentucky,35300,64100,52,2,Private,4 Year,9385,24850,34235,24850,34235
Louisiana Tech University,Louisiana,53100,100700,57,24,Public,4 Year,6495,9645,16140,18558,25053
Louisiana State University Health Sciences Center-New Orleans,Louisiana,52300,94200,86,2,Public,4 Year,5650,6923,12573,13705,19355
University of Louisiana at Monroe,Louisiana,48500,92500,65,7,Public,4 Year,7850,8734,16584,20834,28684
University of Louisiana at Lafayette,Louisiana,48200,92500,52,19,Public,4 Year,8516,10616,19132,24344,32860
University of New Orleans,Louisiana,49900,91600,55,23,Public,4 Year,10575,9054,19629,13890,24465
Loyola University New Orleans,Louisiana,47900,88600,47,4,Private,4 Year,13380,39692,53072,39692,53072
Centenary College of Louisiana,Louisiana,47000,88400,37,26,Private,4 Year,13400,36580,49980,36580,49980
McNeese State University,Louisiana,50200,88200,57,13,Public,4 Year,8704,7859,16563,18934,27638
Xavier University of Louisiana,Louisiana,46700,88200,63,35,Private,4 Year,9047,24488,33535,24488,33535
Nicholls State University,Louisiana,44500,84300,53,5,Public,4 Year,9938,7982,17920,9075,19013
Southeastern Louisiana University,Louisiana,46700,83900,51,8,Public,4 Year,8420,8165,16585,20643,29063
Louisiana College,Louisiana,44800,79800,58,4,Private,4 Year,5618,17000,22618,17000,22618
Dillard University,Louisiana,44700,79800,74,20,Private,4 Year,10100,18099,28199,18099,28199
Grambling State University,Louisiana,43100,73100,66,10,Public,4 Year,7192,7435,14627,16458,23650
Southern University at New Orleans,Louisiana,40100,71000,76,13,Public,4 Year,9040,9371,18411,11160,20200
Maine Maritime Academy,Maine,67000,121800,65,48,Public,4 Year,10310,13478,23788,27098,37408
Bowdoin College,Maine,61300,112000,54,37,Private,4 Year,14698,53922,68620,53922,68620
Bates College,Maine,59500,111900,50,23,Private,4 Year,15224,53794,69018,53794,69018
Colby College,Maine,59200,103300,50,25,Private,4 Year,14190,55210,69400,55210,69400
University of Maine,Maine,52000,95000,50,24,Public,4 Year,10418,11170,21588,30970,41388
University of New England,Maine,50100,91500,69,7,Private,4 Year,13990,37620,51610,37620,51610
Saint Joseph's College of Maine,Maine,46900,84300,60,2,Private,4 Year,13680,35650,49330,35650,49330
Thomas College,Maine,46100,81500,49,3,Private,4 Year,11250,26900,38150,26900,38150
University of Southern Maine,Maine,46900,81300,55,8,Public,4 Year,9450,9520,18970,22780,32230
Husson University,Maine,43300,77600,52,1,Private,4 Year,9830,18180,28010,18180,28010
University of Maine at Fort Kent,Maine,43500,76300,73,5,Public,4 Year,8220,8115,16335,12315,20535
University of Maine at Farmington,Maine,41100,71700,64,5,Public,4 Year,9726,9666,19392,19778,29504
University of Maine at Presque Isle,Maine,39000,70700,58,6,Public,4 Year,8406,8035,16441,12235,20641
University of Maine at Machias,Maine,37100,66200,47,13,Public,4 Year,8486,7840,16326,15100,23586
Maine College of Art,Maine,36300,64600,37,0,Private,4 Year,11890,35000,46890,35000,46890
Capitol Technology University,Maryland,67400,118400,63,88,Private,4 Year,5708,25428,31136,25428,31136
Johns Hopkins University,Maryland,67200,117100,57,31,Private,4 Year,15836,54240,70076,54240,70076
University of Maryland-College Park,Maryland,61300,113400,50,33,Public,4 Year,12429,10595,23024,35216,47645
Loyola University Maryland,Maryland,59900,111200,40,8,Private,4 Year,14430,49085,63515,49085,63515
University of Maryland-Baltimore County,Maryland,58100,103600,54,45,Public,4 Year,11696,11778,23474,26872,38568
Washington Adventist University,Maryland,55600,97600,63,9,Private,4 Year,9370,23900,33270,23900,33270
St Mary's College of Maryland,Maryland,53300,95400,45,27,Public,4 Year,13202,14806,28008,30568,43770
McDaniel College,Maryland,51100,94600,54,6,Private,4 Year,11430,43260,54690,43260,54690
Mount St. Mary's University,Maryland,50200,94100,50,11,Private,4 Year,13075,41350,54425,41350,54425
Washington College,Maryland,52800,93500,55,21,Private,4 Year,12414,46978,59392,46978,59392
Stevenson University,Maryland,50400,91600,51,15,Private,4 Year,13130,36182,49312,36182,49312
Towson University,Maryland,51200,91200,47,15,Public,4 Year,13034,9940,22974,23208,36242
Goucher College,Maryland,49400,90600,42,11,Private,4 Year,14506,44300,58806,44300,58806
Bowie State University,Maryland,50300,89900,65,11,Public,4 Year,10904,8233,19137,18873,29777
Salisbury University,Maryland,50400,89800,51,12,Public,4 Year,11950,9824,21774,19526,31476
Frostburg State University,Maryland,49600,87000,48,19,Public,4 Year,10202,9172,19374,22892,33094
University of Maryland Eastern Shore,Maryland,48300,86700,63,14,Public,4 Year,9864,8302,18166,18508,28372
Notre Dame of Maryland University,Maryland,48300,86400,58,3,Private,4 Year,11850,36900,48750,36900,48750
Maryland Institute College of Art,Maryland,49000,84500,40,0,Private,4 Year,13280,48630,61910,48630,61910
Hood College,Maryland,47900,82600,49,32,Private,4 Year,12700,39492,52192,39492,52192
Massachusetts Institute of Technology,Massachusetts,86300,155200,52,69,Private,4 Year,15510,51832,67342,51832,67342
Worcester Polytechnic Institute,Massachusetts,73600,135500,47,86,Private,4 Year,14774,50530,65304,50530,65304
Babson College,Massachusetts,72000,133800,37,0,Private,4 Year,16312,51104,67416,51104,67416
Williams College,Massachusetts,67500,127500,47,32,Private,4 Year,14500,55450,69950,55450,69950
MCPHS University,Massachusetts,65900,121800,71,2,Private,4 Year,16400,32705,49105,32705,49105
Tufts University,Massachusetts,65200,118100,49,25,Private,4 Year,14560,56382,70942,56382,70942
Massachusetts Maritime Academy,Massachusetts,67900,117500,53,47,Public,4 Year,12675,9724,22399,26102,38777
Bentley University,Massachusetts,66600,116600,36,7,Private,4 Year,16320,49880,66200,49880,66200
Amherst College,Massachusetts,63800,116500,45,32,Private,4 Year,14740,56426,71166,56426,71166
Boston College,Massachusetts,63600,115400,43,13,Private,4 Year,14478,55464,69942,55464,69942
College of the Holy Cross,Massachusetts,61800,114600,46,24,Private,4 Year,14520,52770,67290,52770,67290
Boston University,Massachusetts,61400,113600,43,25,Private,4 Year,15720,53948,69668,53948,69668
Brandeis University,Massachusetts,60600,113200,48,29,Private,4 Year,15440,55395,70835,55395,70835
Wentworth Institute of Technology,Massachusetts,62700,112700,53,39,Private,4 Year,14190,33950,48140,33950,48140
Northeastern University,Massachusetts,62500,109700,46,40,Private,4 Year,16880,51387,68267,51387,68267
University of Massachusetts-Lowell,Massachusetts,58800,109300,53,35,Public,4 Year,12748,15180,27928,32827,45575
Wellesley College,Massachusetts,58900,106200,48,34,Private,4 Year,16468,53732,70200,53732,70200
Stonehill College,Massachusetts,55900,103200,42,18,Private,4 Year,16000,42746,58746,42746,58746
Western New England University,Massachusetts,56400,103000,44,21,Private,4 Year,13590,36804,50394,36804,50394
University of Massachusetts-Amherst,Massachusetts,57400,103000,46,24,Public,4 Year,13202,16072,29274,34755,47957
Merrimack College,Massachusetts,56000,102500,50,13,Private,4 Year,15845,41760,57605,41760,57605
Clark University,Massachusetts,52600,101400,47,14,Private,4 Year,9170,45730,54900,45730,54900
Smith College,Massachusetts,52700,98200,51,26,Private,4 Year,17520,52404,69924,52404,69924
Kettering University,Michigan,69900,125000,44,74,Private,4 Year,8240,43490,51730,43490,51730
Michigan Technological University,Michigan,65000,116300,47,81,Public,4 Year,10756,15646,26402,33726,44482
Lawrence Technological University,Michigan,57900,108400,49,60,Private,4 Year,9950,33570,43520,33570,43520
Michigan State University,Michigan,55300,100800,46,20,Public,4 Year,10322,14460,24782,39765,50087
Albion College,Michigan,52100,99300,44,23,Private,4 Year,12380,45775,58155,45775,58155
Kalamazoo College,Michigan,51600,94500,52,31,Private,4 Year,9756,48516,58272,48516,58272
Oakland University,Michigan,51300,93300,49,19,Public,4 Year,10100,12606,22706,24230,34330
University of Detroit Mercy,Michigan,51800,92800,57,13,Private,4 Year,9496,28000,37496,28000,37496
Western Michigan University,Michigan,50900,92200,47,16,Public,4 Year,9854,13959,23813,13959,23813
Western Michigan University,Michigan,50900,92200,47,16,Public,4 Year,10143,12483,22626,15373,25516
Wayne State University,Michigan,50800,91700,53,21,Public,4 Year,10427,13347,23774,28241,38668
Calvin College,Michigan,50200,91100,54,23,Private,4 Year,10200,34600,44800,34600,44800
Hope College,Michigan,49200,90900,51,18,Private,4 Year,10310,34010,44320,34010,44320
Alma College,Michigan,48400,89900,52,15,Private,4 Year,10998,40258,51256,40258,51256
College for Creative Studies,Michigan,51200,89800,40,0,Private,4 Year,8800,44110,52910,44110,52910
Ferris State University,Michigan,50000,89300,50,8,Public,4 Year,9894,12630,22524,12630,22524
Eastern Michigan University,Michigan,47300,86700,50,6,Public,4 Year,9854,13959,23813,13959,23813
Eastern Michigan University,Michigan,47300,86700,50,6,Public,4 Year,10143,12483,22626,15373,25516
Andrews University,Michigan,47600,85000,51,7,Private,4 Year,9078,29288,38366,29288,38366
Cleary University,Michigan,47400,84700,50,0,Private,4 Year,9600,20250,29850,20250,29850
Central Michigan University,Michigan,47700,83600,46,13,Public,4 Year,10076,12960,23036,12960,23036
Lake Superior State University,Michigan,45900,83500,48,14,Public,4 Year,9882,12090,21972,12090,21972
Saginaw Valley State University,Michigan,46400,82200,54,12,Public,4 Year,10186,10308,20494,24215,34401
Carleton College,Minnesota,58800,109900,47,45,Private,4 Year,14085,54759,68844,54759,68844
University of Minnesota-Twin Cities,Minnesota,57200,104000,51,30,Public,4 Year,10312,14693,25005,30371,40683
St Olaf College,Minnesota,54100,101900,46,30,Private,4 Year,10850,47840,58690,47840,58690
Macalester College,Minnesota,53600,100400,51,31,Private,4 Year,12156,54344,66500,54344,66500
Gustavus Adolphus College,Minnesota,51200,96800,47,22,Private,4 Year,9910,45400,55310,45400,55310
University of Minnesota-Duluth,Minnesota,53200,95700,48,30,Public,4 Year,7760,13367,21127,18485,26245
Saint Cloud State University,Minnesota,51600,91600,50,15,Public,4 Year,8900,8912,17812,17146,26046
Augsburg University,Minnesota,50500,91000,52,11,Private,4 Year,10280,38800,49080,38800,49080
Minnesota State University-Mankato,Minnesota,51600,90900,54,13,Public,4 Year,8719,8184,16903,16235,24954
Hamline University,Minnesota,48100,90400,52,5,Private,4 Year,10358,41298,51656,41298,51656
Winona State University,Minnesota,49700,86800,51,10,Public,4 Year,9010,9425,18435,15348,24358
University of Minnesota-Crookston,Minnesota,49200,86400,54,4,Public,4 Year,7658,11921,19579,11921,19579
University of Minnesota-Morris,Minnesota,46100,85300,53,27,Public,4 Year,8342,13314,21656,15342,23684
Minneapolis College of Art and Design,Minnesota,47400,84700,39,0,Private,4 Year,5610,39210,44820,39210,44820
St Catherine University,Minnesota,48800,82600,65,2,Private,4 Year,9260,39669,48929,39669,48929
Mississippi State University,Mississippi,51100,94100,57,27,Public,4 Year,10090,8760,18850,23360,33450
University of Mississippi,Mississippi,48500,89100,55,12,Public,4 Year,10696,8660,19356,24614,35310
Millsaps College,Mississippi,49300,88700,56,24,Private,4 Year,13730,39910,53640,39910,53640
University of Southern Mississippi,Mississippi,45100,83900,56,11,Public,4 Year,9857,8734,18591,10734,20591
Mississippi College,Mississippi,45200,79500,57,20,Private,4 Year,10300,18026,28326,18026,28326
Jackson State University,Mississippi,41700,74600,67,16,Public,4 Year,9552,8226,17778,19454,29006
Belhaven University,Mississippi,41200,74300,60,2,Private,4 Year,8500,25300,33800,25300,33800
Delta State University,Mississippi,40800,74200,63,5,Public,4 Year,7722,7246,14968,7246,14968
William Carey University,Mississippi,41100,71800,61,6,Private,4 Year,6810,12600,19410,12600,19410
Alcorn State University,Mississippi,40900,69500,67,19,Public,4 Year,9608,7144,16752,7144,16752
Mississippi University for Women,Mississippi,39500,69500,63,2,Public,4 Year,7424,7040,14464,7040,14464
Tougaloo College,Mississippi,36900,66400,69,18,Private,4 Year,6643,10790,17433,10790,17433
Rust College,Mississippi,34800,62400,76,32,Private,4 Year,4300,9900,14200,9900,14200
Mississippi Valley State University,Mississippi,32500,61900,70,11,Public,4 Year,8043,6570,14613,6570,14613
Missouri University of Science and Technology,Missouri,67300,122600,50,80,Public,4 Year,10274,10169,20443,28499,38773
Washington University in St Louis,Missouri,64800,114900,42,30,Private,4 Year,16440,53399,69839,53399,69839
University of Missouri-Columbia,Missouri,52300,98600,49,17,Public,4 Year,10786,12055,22841,29025,39811
Saint Louis University,Missouri,54200,95300,56,13,Private,4 Year,12290,43884,56174,43884,56174
William Jewell College,Missouri,51400,94500,60,12,Private,4 Year,9930,34400,44330,34400,44330
Rockhurst University,Missouri,54000,92500,59,11,Private,4 Year,10200,37590,47790,37590,47790
University of Missouri-Kansas City,Missouri,50800,89600,55,24,Public,4 Year,10334,9884,20218,25010,35344
Truman State University,Missouri,47900,85800,48,16,Public,4 Year,8780,7729,16509,14581,23361
Northwest Missouri State University,Missouri,46900,85100,50,26,Public,4 Year,10016,9805,19821,16457,26473
Park University,Missouri,48500,85000,56,7,Private,4 Year,8200,12650,20850,12650,20850
Webster University,Missouri,46500,83500,50,2,Private,4 Year,11050,27900,38950,27900,38950
University of Central Missouri,Missouri,46900,83300,54,45,Public,4 Year,8766,7673,16439,14442,23208
Avila University,Missouri,45900,81200,68,3,Private,4 Year,7200,19900,27100,19900,27100
Maryville University of Saint Louis,Missouri,46800,80100,53,2,Private,4 Year,10088,28470,38558,28470,38558
Drury University,Missouri,42600,79400,60,12,Private,4 Year,8096,28365,36461,28365,36461
Southeast Missouri State University,Missouri,43700,79100,52,9,Public,4 Year,8935,7418,16353,13155,22090
Lindenwood University,Missouri,45100,78500,48,9,Private,4 Year,9000,17600,26600,17600,26600
Kansas City Art Institute,Missouri,42500,77700,37,0,Private,4 Year,10400,38400,48800,38400,48800
Stephens College,Missouri,42800,77200,47,6,Private,4 Year,10632,30950,41582,30950,41582
Montana Tech of the University of Montana,Montana,61200,112600,64,61,Public,4 Year,9656,7411,17067,22574,32230
Montana State University,Montana,53700,96200,54,31,Public,4 Year,10100,7421,17521,24849,34949
Carroll College,Montana,48200,91400,55,25,Private,4 Year,9880,35486,45366,35486,45366
Rocky Mountain College,Montana,46000,82900,59,12,Private,4 Year,8330,28512,36842,28512,36842
Montana State University-Billings,Montana,43300,77700,59,5,Public,4 Year,7680,5930,13610,19250,26930
Montana State University-Northern,Montana,43400,75400,63,1,Public,4 Year,6520,5956,12476,18556,25076
University of Nebraska-Lincoln,Nebraska,51500,96700,53,20,Public,4 Year,11430,9154,20584,24949,36379
Creighton University,Nebraska,53500,95800,56,9,Private,4 Year,11036,39916,50952,39916,50952
Clarkson College,Nebraska,50900,91500,74,0,Private,4 Year,5398,16920,22318,16920,22318
University of Nebraska at Omaha,Nebraska,49400,89500,52,18,Public,4 Year,9950,8417,18367,22689,32639
Hastings College,Nebraska,48600,87100,55,14,Private,4 Year,9700,30050,39750,30050,39750
Bellevue University,Nebraska,49400,84800,57,23,Private,4 Year,8730,9390,18120,9390,18120
University of Nebraska at Kearney,Nebraska,44300,80800,52,8,Public,4 Year,9878,7513,17391,14503,24381
Nebraska Wesleyan University,Nebraska,45700,80500,60,8,Private,4 Year,9622,34202,43824,34202,43824
Midland University,Nebraska,43800,78100,60,7,Private,4 Year,8776,32558,41334,32558,41334
College of Saint Mary,Nebraska,43900,77700,45,9,Private,4 Year,7700,20350,28050,20350,28050
Chadron State College,Nebraska,42300,76700,66,3,Public,4 Year,7380,7196,14576,7196,14576
Peru State College,Nebraska,42600,74800,50,6,Public,4 Year,8010,7452,15462,7482,15492
Wayne State College,Nebraska,40600,73400,54,11,Public,4 Year,7668,6989,14657,12299,19967
Sierra Nevada College,Nevada,54000,95500,39,2,Private,4 Year,13357,34241,47598,34241,47598
University of Nevada-Reno,Nevada,52700,95000,47,24,Public,4 Year,10868,7925,18793,22397,33265
University of Nevada-Las Vegas,Nevada,50400,90400,46,12,Public,4 Year,10504,7985,18489,22457,32961
Dartmouth College,New-Hampshire,71500,130900,44,35,Private,4 Year,15756,55453,71209,55453,71209
Saint Anselm College,New-Hampshire,56400,100300,59,11,Private,4 Year,14500,41200,55700,41200,55700
New England College,New-Hampshire,45700,86400,43,24,Private,4 Year,14222,37914,52136,37914,52136
Franklin Pierce University,New-Hampshire,47800,85600,52,3,Private,4 Year,13345,36900,50245,36900,50245
Rivier University,New-Hampshire,49500,85100,58,41,Private,4 Year,12526,31790,44316,31790,44316
Colby-Sawyer College,New-Hampshire,46400,83700,43,7,Private,4 Year,14264,42398,56662,42398,56662
Keene State College,New-Hampshire,48900,83600,49,8,Public,4 Year,11026,14212,25238,23176,34202
Southern New Hampshire University,New-Hampshire,47400,83400,49,8,Private,4 Year,13120,31136,44256,31136,44256
Plymouth State University,New-Hampshire,47000,82200,50,6,Public,4 Year,11100,14099,25199,22769,33869
Stevens Institute of Technology,New-Jersey,75100,139900,47,79,Private,4 Year,15244,52202,67446,52202,67446
Princeton University,New-Jersey,75200,139400,48,48,Private,4 Year,16290,49330,65620,49330,65620
New Jersey Institute of Technology,New-Jersey,64600,121300,51,75,Public,4 Year,13600,17338,30938,32750,46350
Seton Hall University,New-Jersey,57100,103800,45,8,Private,4 Year,15800,42470,58270,42470,58270
The College of New Jersey,New-Jersey,58200,101800,44,16,Public,4 Year,13617,16551,30168,28266,41883
Rider University,New-Jersey,51600,99000,47,5,Private,4 Year,14700,41310,56010,41310,56010
Felician University,New-Jersey,53200,98200,51,10,Private,4 Year,12880,34315,47195,34315,47195
Saint Peter's University,New-Jersey,52900,95900,35,14,Private,4 Year,15414,37486,52900,37486,52900
Montclair State University,New-Jersey,50800,95400,42,9,Public,4 Year,15564,12790,28354,20578,36142
Ramapo College of New Jersey,New-Jersey,51600,95200,41,12,Public,4 Year,12450,14374,26824,23715,36165
Drew University,New-Jersey,52800,95000,37,16,Private,4 Year,14108,39500,53608,39500,53608
Monmouth University,New-Jersey,52200,93200,44,13,Private,4 Year,13981,38138,52119,38138,52119
Fairleigh Dickinson University-Metropolitan Campus,New-Jersey,50800,93000,43,23,Private,4 Year,13348,40236,53584,40236,53584
Rowan University,New-Jersey,51100,91200,43,21,Public,4 Year,12552,13697,26249,22339,34891
William Paterson University of New Jersey,New-Jersey,50500,90200,44,7,Public,4 Year,11445,13060,24505,21260,32705
Kean University,New-Jersey,48200,90000,51,10,Public,4 Year,14470,12348,26818,19383,33853
Bloomfield College,New-Jersey,48400,89100,55,17,Private,4 Year,11950,29550,41500,29550,41500
New Jersey City University,New-Jersey,48700,87600,55,9,Public,4 Year,12738,12051,24789,21573,34311
Stockton University,New-Jersey,47400,85800,49,16,Public,4 Year,12282,13739,26021,20866,33148
New Mexico Institute of Mining and Technology,New-Mexico,64700,120400,61,91,Public,4 Year,8510,7770,16280,22268,30778
Western New Mexico University,New-Mexico,41700,76700,75,4,Public,4 Year,7162,6206,13368,8128,15290
Western New Mexico University,New-Mexico,41700,76700,75,4,Public,4 Year,9136,6824,15960,15231,24367
New Mexico Highlands University,New-Mexico,40400,73800,63,4,Public,4 Year,7872,6150,14022,10302,18174
Albany College of Pharmacy and Health Sciences,New-York,81000,144800,82,2,Private,4 Year,10920,35105,46025,35105,46025
SUNY Maritime College,New-York,74900,140700,53,32,Public,4 Year,12522,8283,20805,18063,30585
Rensselaer Polytechnic Institute,New-York,71300,134100,49,78,Private,4 Year,15260,53880,69140,53880,69140
Colgate University,New-York,68400,130600,41,26,Private,4 Year,13995,55870,69865,55870,69865
Clarkson University,New-York,66400,130100,58,58,Private,4 Year,14908,49444,64352,49444,64352
Cornell University,New-York,70100,128200,45,43,Private,4 Year,14816,55188,70004,55188,70004
Cooper Union for the Advancement of Science and Art,New-York,68500,126200,46,56,Private,4 Year,16638,46700,63338,46700,63338
Manhattan College,New-York,64000,125700,46,40,Private,4 Year,16200,43480,59680,43480,59680
New York University,New-York,63100,117700,42,18,Private,4 Year,18156,51828,69984,51828,69984
Yeshiva University,New-York,63500,112800,40,11,Private,4 Year,12250,43500,55750,43500,55750
University of Rochester,New-York,61100,112700,50,32,Private,4 Year,15938,53926,69864,53926,69864
Fordham University,New-York,58700,112500,38,10,Private,4 Year,17969,52687,70656,52687,70656
Hofstra University,New-York,57300,110400,38,7,Private,4 Year,15948,46760,62708,46760,62708
Barnard College,New-York,59200,109800,57,19,Private,4 Year,17225,55032,72257,55032,72257
Hamilton College,New-York,62600,108100,45,25,Private,4 Year,13870,54620,68490,54620,68490
Duke University,North-Carolina,71100,132100,50,26,Private,4 Year,15178,55695,70873,55695,70873
Wake Forest University,North-Carolina,60700,114800,44,13,Private,4 Year,16032,53322,69354,53322,69354
Davidson College,North-Carolina,57300,106900,50,28,Private,4 Year,14372,51447,65819,51447,65819
University of North Carolina at Chapel Hill,North-Carolina,55000,100800,49,19,Public,4 Year,11190,8987,20177,35170,46360
Elon University,North-Carolina,53600,93700,43,7,Private,4 Year,12230,35319,47549,35319,47549
University of North Carolina at Charlotte,North-Carolina,52500,92600,49,25,Public,4 Year,11100,7044,18144,20478,31578
Queens University of Charlotte,North-Carolina,49400,86600,48,9,Private,4 Year,10860,34684,45544,34684,45544
Lenoir-Rhyne University,North-Carolina,46400,86300,54,7,Private,4 Year,12510,36400,48910,36400,48910
East Carolina University,North-Carolina,48400,85400,55,11,Public,4 Year,9606,7188,16794,23465,33071
High Point University,North-Carolina,48600,84300,50,8,Private,4 Year,14130,35118,49248,35118,49248
Johnson C Smith University,North-Carolina,45700,83300,57,16,Private,4 Year,7100,18236,25336,18236,25336
Belmont Abbey College,North-Carolina,46700,82900,49,7,Private,4 Year,10355,18500,28855,18500,28855
Appalachian State University,North-Carolina,46600,82700,47,9,Public,4 Year,8304,7214,15518,22021,30325
Campbell University,North-Carolina,46300,82400,56,8,Private,4 Year,11430,32500,43930,32500,43930
University of North Carolina School of the Arts,North-Carolina,46400,82400,44,0,Public,4 Year,9021,9358,18379,25501,34522
Methodist University,North-Carolina,45800,80500,58,9,Private,4 Year,12890,33846,46736,33846,46736
North Carolina Wesleyan College,North-Carolina,45300,78800,62,8,Private,4 Year,10800,31000,41800,31000,41800
Catawba College,North-Carolina,42500,78100,58,11,Private,4 Year,10488,30520,41008,30520,41008
Pfeiffer University,North-Carolina,44200,78000,51,4,Private,4 Year,11226,30234,41460,30234,41460
Barton College,North-Carolina,42400,77900,62,6,Private,4 Year,10120,30880,41000,30880,41000
Western Carolina University,North-Carolina,44700,77700,58,8,Public,4 Year,9682,4220,13902,8220,17902
University of North Dakota,North-Dakota,53800,96000,54,16,Public,4 Year,8974,8695,17669,20759,29733
University of Jamestown,North-Dakota,47600,85400,64,11,Private,4 Year,7570,21976,29546,21976,29546
Mayville State University,North-Dakota,43700,81300,44,10,Public,4 Year,7840,6666,14506,9399,17239
Dickinson State University,North-Dakota,46400,81200,55,8,Public,4 Year,6898,6765,13663,9544,16442
University of Mary,North-Dakota,46400,79100,64,3,Private,4 Year,6890,18720,25610,18720,25610
Minot State University,North-Dakota,44500,74100,55,7,Public,4 Year,6610,7064,13674,7064,13674
Valley City State University,North-Dakota,39900,68600,56,3,Public,4 Year,6446,7626,14072,17166,23612
Case Western Reserve University,Ohio,66600,117800,44,37,Private,4 Year,15190,49042,64232,49042,64232
Miami University-Oxford,Ohio,57200,107300,46,22,Public,4 Year,13860,15378,29238,34895,48755
Wittenberg University,Ohio,52400,105400,61,22,Private,4 Year,10356,39500,49856,39500,49856
University of Dayton,Ohio,57400,105000,44,33,Private,4 Year,13580,42900,56480,42900,56480
Denison University,Ohio,54400,104800,45,22,Private,4 Year,12710,51960,64670,51960,64670
Ohio Northern University,Ohio,54400,103900,49,22,Private,4 Year,11650,32260,43910,32260,43910
Kenyon College,Ohio,55000,103800,50,17,Private,4 Year,12510,55930,68440,55930,68440
Mount Carmel College of Nursing,Ohio,56600,99700,78,0,Private,4 Year,5000,13907,18907,13907,18907
Ohio Wesleyan University,Ohio,51300,99200,46,21,Private,4 Year,12430,45760,58190,45760,58190
John Carroll University,Ohio,51600,97300,39,16,Private,4 Year,11874,41340,53214,41340,53214
Oberlin College,Ohio,53100,96800,47,21,Private,4 Year,16338,55054,71392,55054,71392
Marietta College,Ohio,51200,94300,57,45,Private,4 Year,11320,36040,47360,36040,47360
Xavier University,Ohio,51800,94000,46,7,Private,4 Year,12780,38530,51310,38530,51310
University of Toledo,Ohio,51800,92500,52,21,Public,4 Year,11434,9795,21229,19133,30567
Cleveland State University,Ohio,48300,88600,51,20,Public,4 Year,13560,10625,24185,14992,28552
University of Mount Union,Ohio,48300,88500,41,19,Private,4 Year,10200,31260,41460,31260,41460
University of Tulsa,Oklahoma,58700,107200,51,36,Private,4 Year,11116,41509,52625,41509,52625
Southwestern Oklahoma State University,Oklahoma,47900,90800,58,5,Public,4 Year,4780,7036,11816,14153,18933
Southwestern Oklahoma State University,Oklahoma,47900,90800,58,5,Public,4 Year,6970,6750,13720,15390,22360
Southwestern Oklahoma State University,Oklahoma,47900,90800,58,5,Public,4 Year,5830,7035,12865,13935,19765
Oklahoma City University,Oklahoma,47700,87900,58,9,Private,4 Year,8896,31026,39922,31026,39922
Oklahoma Christian University,Oklahoma,49700,87900,57,41,Private,4 Year,8190,22760,30950,22760,30950
Oral Roberts University,Oklahoma,45900,85100,59,8,Private,4 Year,9450,27728,37178,27728,37178
University of Central Oklahoma,Oklahoma,45300,82900,56,8,Public,4 Year,7970,7488,15458,18376,26346
Langston University,Oklahoma,46500,81500,66,8,Public,4 Year,9476,5950,15426,13300,22776
Cameron University,Oklahoma,43900,81500,54,14,Public,4 Year,5452,6450,11902,15870,21322
Southern Nazarene University,Oklahoma,46100,81000,62,5,Private,4 Year,8496,25188,33684,25188,33684
Southeastern Oklahoma State University,Oklahoma,45000,80500,53,15,Public,4 Year,6970,6750,13720,15390,22360
Southeastern Oklahoma State University,Oklahoma,45000,80500,53,15,Public,4 Year,5830,7035,12865,13935,19765
Oklahoma Wesleyan University,Oklahoma,43300,78700,58,1,Private,4 Year,8644,26956,35600,26956,35600
Northeastern State University,Oklahoma,44500,77600,58,7,Public,4 Year,7638,6650,14288,14720,22358
East Central University,Oklahoma,44700,77500,66,9,Public,4 Year,5514,6810,12324,17700,23214
Northwestern Oklahoma State University,Oklahoma,42200,76800,55,11,Public,4 Year,4780,7036,11816,14153,18933
Northwestern Oklahoma State University,Oklahoma,42200,76800,55,11,Public,4 Year,5830,7035,12865,13935,19765
Oklahoma Baptist University,Oklahoma,43900,76600,62,8,Private,4 Year,7350,28258,35608,28258,35608
Oklahoma Panhandle State University,Oklahoma,42300,74400,54,10,Public,4 Year,4695,8194,12889,9133,13828
Mid-America Christian University,Oklahoma,40700,74100,71,0,Private,4 Year,8036,18334,26370,18334,26370
Rogers State University,Oklahoma,41400,73800,48,11,Public,4 Year,8616,6870,15486,15210,23826
University of Science and Arts of Oklahoma,Oklahoma,37300,67400,49,11,Public,4 Year,6350,7215,13565,17565,23915
Oregon Institute of Technology,Oregon,61200,106800,60,27,Public,4 Year,9058,9987,19045,28056,37114
University of Portland,Oregon,58500,104900,52,28,Private,4 Year,13450,45904,59354,45904,59354
Reed College,Oregon,56100,104900,44,26,Private,4 Year,14210,56340,70550,56340,70550
Oregon State University,Oregon,56200,104800,53,34,Public,4 Year,12855,11166,24021,30141,42996
Willamette University,Oregon,52200,97700,49,14,Private,4 Year,12440,50074,62514,50074,62514
University of Oregon,Oregon,51800,95800,46,13,Public,4 Year,12963,11898,24861,35478,48441
Pacific University,Oregon,50200,94000,66,8,Private,4 Year,12528,44298,56826,44298,56826
Lewis & Clark College,Oregon,50000,93200,51,12,Private,4 Year,12490,50934,63424,50934,63424
Portland State University,Oregon,50800,90500,48,16,Public,4 Year,10428,9105,19533,27060,37488
George Fox University,Oregon,51200,89600,52,8,Private,4 Year,11250,36020,47270,36020,47270
Southern Oregon University,Oregon,46000,81200,54,6,Public,4 Year,13199,9654,22853,25584,38783
Northwest Christian University,Oregon,45200,81100,62,5,Private,4 Year,9300,30050,39350,30050,39350
Western Oregon University,Oregon,44500,79300,50,5,Public,4 Year,10040,8679,18719,20739,30779
Western Oregon University,Oregon,44500,79300,50,5,Public,4 Year,10415,9540,19955,26415,36830
Corban University,Oregon,42500,77300,63,1,Private,4 Year,10228,33040,43268,33040,43268
Multnomah University,Oregon,40500,76400,82,0,Private,4 Year,8870,25900,34770,25900,34770
Eastern Oregon University,Oregon,44000,73900,56,5,Public,4 Year,10040,8679,18719,20739,30779
Eastern Oregon University,Oregon,44000,73900,56,5,Public,4 Year,10415,9540,19955,26415,36830
Carnegie Mellon University,Pennsylvania,75900,136100,45,66,Private,4 Year,14418,55465,69883,55465,69883
Lehigh University,Pennsylvania,69500,134100,45,52,Private,4 Year,13600,52930,66530,52930,66530
University of Pennsylvania,Pennsylvania,72800,133900,41,21,Private,4 Year,15616,55584,71200,55584,71200
Swarthmore College,Pennsylvania,67500,123200,44,45,Private,4 Year,15474,52588,68062,52588,68062
Bucknell University,Pennsylvania,66700,122900,40,40,Private,4 Year,13662,56092,69754,56092,69754
Lafayette College,Pennsylvania,66500,122500,37,47,Private,4 Year,15640,52880,68520,52880,68520
Villanova University,Pennsylvania,65100,119500,41,23,Private,4 Year,14020,53308,67328,53308,67328
University of the Sciences,Pennsylvania,60700,115200,72,12,Private,4 Year,15938,25000,40938,25000,40938
Drexel University,Pennsylvania,61700,114800,47,28,Private,4 Year,14079,53279,67358,53279,67358
Haverford College,Pennsylvania,59300,112300,47,36,Private,4 Year,16402,54592,70994,54592,70994
Gettysburg College,Pennsylvania,58400,109300,39,24,Private,4 Year,13010,54480,67490,54480,67490
Saint Joseph's University,Pennsylvania,57300,105100,41,6,Private,4 Year,14840,44973,59813,44973,59813
La Salle University,Pennsylvania,55800,104800,40,5,Private,4 Year,15080,30560,45640,30560,45640
Muhlenberg College,Pennsylvania,53400,101900,43,20,Private,4 Year,11765,52595,64360,52595,64360
Ursinus College,Pennsylvania,54400,101800,42,40,Private,4 Year,12750,52050,64800,52050,64800
Dickinson College,Pennsylvania,55800,100100,46,25,Private,4 Year,13698,54661,68359,54661,68359
Widener University,Pennsylvania,55700,100100,57,13,Private,4 Year,14446,45948,60394,45948,60394
University of Scranton,Pennsylvania,56400,99700,42,12,Private,4 Year,15182,44532,59714,44532,59714
Grove City College,Pennsylvania,54400,98400,53,29,Private,4 Year,9770,17930,27700,17930,27700
Brown University,Rhode-Island,68200,127600,45,43,Private,4 Year,14670,55656,70326,55656,70326
Bryant University,Rhode-Island,60500,108600,37,8,Private,4 Year,15702,43973,59675,43973,59675
Providence College,Rhode-Island,58900,106900,44,11,Private,4 Year,14700,50390,65090,50390,65090
Rhode Island School of Design,Rhode-Island,55500,100600,39,0,Private,4 Year,13400,50960,64360,50960,64360
University of Rhode Island,Rhode-Island,54500,99700,50,18,Public,4 Year,12950,14138,27088,30862,43812
Salve Regina University,Rhode-Island,53000,93900,50,6,Private,4 Year,14500,40550,55050,40550,55050
New England Institute of Technology,Rhode-Island,51700,93200,44,14,Private,4 Year,13065,29940,43005,29940,43005
Roger Williams University,Rhode-Island,52900,92700,48,12,Private,4 Year,15890,34522,50412,34522,50412
Rhode Island College,Rhode-Island,47200,83500,52,5,Public,4 Year,11829,8929,20758,21692,33521
Johnson & Wales University-Providence,Rhode-Island,46500,78900,41,5,Private,4 Year,14337,32091,46428,32091,46428
Clemson University,South-Carolina,57500,106700,50,39,Public,4 Year,10832,14970,25802,36724,47556
Wofford College,South-Carolina,51300,96600,51,28,Private,4 Year,12685,43845,56530,43845,56530
Presbyterian College,South-Carolina,48800,89900,57,14,Private,4 Year,10480,38660,49140,38660,49140
College of Charleston,South-Carolina,47300,85100,44,20,Public,4 Year,12166,12738,24904,31920,44086
University of South Carolina-Upstate,South-Carolina,46000,81400,50,13,Public,4 Year,9480,11763,21243,23265,32745
South Carolina State University,South-Carolina,44500,80800,71,16,Public,4 Year,9890,11060,20950,21750,31640
Winthrop University,South-Carolina,44300,79700,49,9,Public,4 Year,9312,15590,24902,29846,39158
Erskine College,South-Carolina,43500,78000,57,28,Private,4 Year,10900,34560,45460,34560,45460
Coastal Carolina University,South-Carolina,44700,77600,48,14,Public,4 Year,9190,11536,20726,26648,35838
Francis Marion University,South-Carolina,42900,77600,58,18,Public,4 Year,7948,11160,19108,21544,29492
Lander University,South-Carolina,42600,77100,54,9,Public,4 Year,9100,11700,20800,21300,30400
Limestone College,South-Carolina,42100,76500,57,10,Private,4 Year,9765,26000,35765,26000,35765
Charleston Southern University,South-Carolina,42800,76300,65,9,Private,4 Year,10200,25500,35700,25500,35700
University of South Carolina-Aiken,South-Carolina,41600,75100,58,10,Public,4 Year,7766,10760,18526,21218,28984
Newberry College,South-Carolina,41200,74700,54,14,Private,4 Year,10666,26424,37090,26424,37090
Southern Wesleyan University,South-Carolina,42900,74600,52,5,Private,4 Year,9030,25476,34506,25476,34506
Converse College,South-Carolina,39000,71000,60,8,Private,4 Year,10930,18690,29620,18690,29620
Benedict College,South-Carolina,38100,67500,61,19,Private,4 Year,6200,16600,22800,16600,22800
Columbia International University,South-Carolina,36600,66200,62,0,Private,4 Year,8150,23690,31840,23690,31840
South Dakota School of Mines and Technology,South-Dakota,66500,118500,58,92,Public,4 Year,8440,9779,18219,14021,22461
South Dakota State University,South-Dakota,50500,91900,58,18,Public,4 Year,7896,8764,16660,12128,20024
Augustana University,South-Dakota,47900,88400,54,18,Private,4 Year,8248,33018,41266,33018,41266
University of South Dakota,South-Dakota,47500,87900,56,8,Public,4 Year,8216,9061,17277,12425,20641
Dakota State University,South-Dakota,48400,84300,49,53,Public,4 Year,6873,9276,16149,12249,19122
University of Sioux Falls,South-Dakota,44400,78200,64,6,Private,4 Year,7350,18280,25630,18280,25630
Northern State University,South-Dakota,42300,77700,56,7,Public,4 Year,8029,8498,16527,11471,19500
Mount Marty College,South-Dakota,41400,76500,67,5,Private,4 Year,7986,27276,35262,27276,35262
Dakota Wesleyan University,South-Dakota,41800,75700,52,10,Private,4 Year,7350,27300,34650,27300,34650
Black Hills State University,South-Dakota,40400,72600,51,11,Public,4 Year,6978,8733,15711,11778,18756
Vanderbilt University,Tennessee,65400,119100,48,23,Private,4 Year,16234,49816,66050,49816,66050
Sewanee-The University of the South,Tennessee,53700,97800,57,17,Private,4 Year,12880,45120,58000,45120,58000
Rhodes College,Tennessee,51900,97800,46,25,Private,4 Year,11403,47890,59293,47890,59293
Christian Brothers University,Tennessee,51500,96500,60,14,Private,4 Year,7400,32820,40220,32820,40220
Tennessee Technological University,Tennessee,53100,95100,48,28,Public,4 Year,9736,9103,18839,25759,35495
University of Memphis,Tennessee,47200,85800,55,12,Public,4 Year,9975,9701,19676,21413,31388
Lipscomb University,Tennessee,49000,84800,59,12,Private,4 Year,12652,32144,44796,32144,44796
Southern Adventist University,Tennessee,47500,84000,67,9,Private,4 Year,6940,21950,28890,21950,28890
Fisk University,Tennessee,45300,83600,53,39,Private,4 Year,10790,21480,32270,21480,32270
Union University,Tennessee,46400,83000,59,6,Private,4 Year,10200,32890,43090,32890,43090
Trevecca Nazarene University,Tennessee,45300,81700,65,5,Private,4 Year,8400,25598,33998,25598,33998
Middle Tennessee State University,Tennessee,46500,81100,52,9,Public,4 Year,9436,9206,18642,28364,37800
Cumberland University,Tennessee,45500,81000,61,3,Private,4 Year,9290,22890,32180,22890,32180
Belmont University,Tennessee,47300,80900,47,3,Private,4 Year,12120,34310,46430,34310,46430
Tennessee State University,Tennessee,47200,78400,68,14,Public,4 Year,7806,8008,15814,21364,29170
Freed-Hardeman University,Tennessee,43700,78200,54,9,Private,4 Year,8260,21950,30210,21950,30210
Austin Peay State University,Tennessee,44200,78200,63,10,Public,4 Year,10700,8411,19111,24467,35167
East Tennessee State University,Tennessee,43700,77300,57,8,Public,4 Year,8472,9277,17749,28459,36931
Carson-Newman University,Tennessee,42700,76500,61,5,Private,4 Year,8810,27900,36710,27900,36710
Maryville College,Tennessee,42800,75300,68,16,Private,4 Year,11424,34880,46304,34880,46304
Milligan College,Tennessee,41200,74900,63,5,Private,4 Year,7100,33700,40800,33700,40800
Rice University,Texas,71000,129500,50,45,Private,4 Year,14000,47350,61350,47350,61350
Southern Methodist University,Texas,59700,110400,46,22,Private,4 Year,16845,54493,71338,54493,71338
Texas Tech University,Texas,56800,106500,54,22,Public,4 Year,9530,11045,20575,23495,33025
University of Houston,Texas,56000,103900,50,24,Public,4 Year,10270,12506,22776,27956,38226
Trinity University,Texas,54900,102900,46,27,Private,4 Year,13464,42976,56440,42976,56440
Baylor University,Texas,55500,101400,49,16,Private,4 Year,12595,45727,58322,45727,58322
Lamar University,Texas,53300,101200,57,16,Public,4 Year,8920,10192,19112,22642,31562
Prairie View A&M University,Texas,57800,99400,65,22,Public,4 Year,8925,10533,19458,24843,33768
LeTourneau University,Texas,56600,98900,53,21,Private,4 Year,9970,30210,40180,30210,40180
Texas Christian University,Texas,56000,98700,51,9,Private,4 Year,12804,46950,59754,46950,59754
Texas A&M University-Kingsville,Texas,53100,97500,63,53,Public,4 Year,8760,8462,17222,20912,29672
University of Dallas,Texas,53000,96400,49,16,Private,4 Year,12400,40652,53052,40652,53052
St. Mary's University,Texas,52900,95300,61,17,Private,4 Year,10270,30650,40920,30650,40920
Southwestern University,Texas,51800,93500,51,19,Private,4 Year,12000,42000,54000,42000,54000
University of Utah,Utah,54800,102600,57,22,Public,4 Year,10262,9222,19484,29215,39477
Weber State University,Utah,53900,94000,60,8,Public,4 Year,6279,5831,12110,16585,22864
Utah State University,Utah,52400,93900,61,14,Public,4 Year,6400,7424,13824,21505,27905
Southern Utah University,Utah,46400,84400,65,7,Public,4 Year,7090,6769,13859,20585,27675
Middlebury College,Vermont,60400,109800,54,19,Private,4 Year,15530,54450,69980,54450,69980
University of Vermont,Vermont,53200,99400,50,22,Public,4 Year,12462,18276,30738,42516,54978
Norwich University,Vermont,57000,99100,51,20,Private,4 Year,13840,40016,53856,40016,53856
Saint Michael's College,Vermont,52900,98500,40,18,Private,4 Year,12220,45375,57595,45375,57595
Vermont Technical College,Vermont,52400,93900,41,4,Public,4 Year,10598,15108,25706,27780,38378
Bennington College,Vermont,48800,90000,50,5,Private,4 Year,15610,54360,69970,54360,69970
Champlain College,Vermont,51100,88400,39,14,Private,4 Year,15354,41010,56364,41010,56364
Southern Vermont College,Vermont,42900,78700,63,17,Private,4 Year,11000,25511,36511,25511,36511
Castleton University,Vermont,41700,76200,52,6,Public,4 Year,10598,12314,22912,28322,38920
Green Mountain College,Vermont,42000,75200,57,2,Private,4 Year,11722,37002,48724,37002,48724
Lyndon State College,Vermont,41500,75100,49,8,Public,4 Year,10598,12074,22672,25394,35992
Washington and Lee University,Virginia,65900,123200,40,18,Private,4 Year,13925,52455,66380,52455,66380
Virginia Military Institute,Virginia,65900,120600,68,47,Public,4 Year,9428,18862,28290,45706,55134
Virginia Polytechnic Institute and State University,Virginia,62700,114000,48,42,Public,4 Year,8934,13620,22554,31304,40238
College of William and Mary,Virginia,59000,108900,42,21,Public,4 Year,12236,23400,35636,44701,56937
Hampden-Sydney College,Virginia,58300,108600,52,20,Private,4 Year,13558,45746,59304,45746,59304
University of Richmond,Virginia,59800,107500,48,13,Private,4 Year,12250,52610,64860,52610,64860
George Mason University,Virginia,58900,105700,48,23,Public,4 Year,11460,12462,23922,35922,47382
James Madison University,Virginia,57400,102600,42,12,Public,4 Year,10092,12016,22108,28416,38508
University of Mary Washington,Virginia,54200,98200,49,17,Public,4 Year,11118,12188,23306,27434,38552
Jefferson College of Health Sciences,Virginia,55500,97600,86,1,Private,4 Year,5870,26886,32756,26886,32756
Marymount University,Virginia,52300,93100,44,15,Private,4 Year,13190,31466,44656,31466,44656
Hampton University,Virginia,52700,92600,61,12,Private,4 Year,11778,26702,38480,26702,38480
Old Dominion University,Virginia,50200,89900,52,19,Public,4 Year,11620,10872,22492,29772,41392
Virginia Commonwealth University,Virginia,49900,88200,52,18,Public,4 Year,10428,14490,24918,35138,45566
Christopher Newport University,Virginia,50800,87200,55,25,Public,4 Year,11460,14754,26214,27220,38680
Shenandoah University,Virginia,48700,86600,57,7,Private,4 Year,10370,32530,42900,32530,42900
Randolph College,Virginia,47000,86100,50,23,Private,4 Year,13580,39585,53165,39585,53165
Roanoke College,Virginia,48500,85100,53,18,Private,4 Year,13690,44030,57720,44030,57720
Longwood University,Virginia,47300,83300,54,9,Public,4 Year,11746,13340,25086,29300,41046
Radford University,Virginia,48900,82900,53,10,Public,4 Year,9406,11210,20616,22845,32251
Virginia State University,Virginia,44900,81800,61,14,Public,4 Year,11208,9056,20264,19576,30784
Ferrum College,Virginia,43000,80600,54,6,Private,4 Year,11500,34175,45675,34175,45675
Seattle University,Washington,60600,113700,59,12,Private,4 Year,12288,44610,56898,44610,56898
Gonzaga University,Washington,57800,107600,51,19,Private,4 Year,11944,43210,55154,43210,55154
Washington State University,Washington,55900,103700,50,20,Public,4 Year,11398,11581,22979,26365,37763
Seattle Pacific University,Washington,53600,103400,52,9,Private,4 Year,11796,42939,54735,42939,54735
Whitman College,Washington,54600,102600,53,33,Private,4 Year,13174,51764,64938,51764,64938
University of Puget Sound,Washington,54200,101300,45,21,Private,4 Year,12540,49776,62316,49776,62316
Western Washington University,Washington,55000,99300,45,16,Public,4 Year,12793,7323,20116,24444,37237
Western Washington University,Washington,55000,99300,45,16,Public,4 Year,11466,8132,19598,23544,35010
Pacific Lutheran University,Washington,54500,98100,53,20,Private,4 Year,10790,42066,52856,42066,52856
Walla Walla University,Washington,53700,97800,54,22,Private,4 Year,4275,28035,32310,28035,32310
Central Washington University,Washington,52700,93200,47,13,Public,4 Year,11115,8072,19187,23053,34168
Saint Martin's University,Washington,53200,91800,60,29,Private,4 Year,11445,37356,48801,37356,48801
Northwest University,Washington,50900,89000,51,3,Private,4 Year,8630,31540,40170,31540,40170
Whitworth University,Washington,49900,88800,52,18,Private,4 Year,11496,43640,55136,43640,55136
Eastern Washington University,Washington,49500,87500,52,17,Public,4 Year,12793,7323,20116,24444,37237
Eastern Washington University,Washington,49500,87500,52,17,Public,4 Year,11466,8132,19598,23544,35010
Cornish College of the Arts,Washington,49000,86400,39,0,Private,4 Year,12400,41642,54042,41642,54042
West Virginia University Institute of Technology,West-Virginia,57100,103700,56,40,Public,4 Year,11390,7464,18854,18648,30038
West Virginia University,West-Virginia,54400,99900,52,22,Public,4 Year,10918,8856,19774,24950,35868
Alderson Broaddus University,West-Virginia,50600,90500,72,15,Private,4 Year,8860,27910,36770,27910,36770
Shepherd University,West-Virginia,47100,87100,48,12,Public,4 Year,10500,7548,18048,18048,28548
West Virginia Wesleyan College,West-Virginia,47000,85200,53,21,Private,4 Year,8856,31640,40496,31640,40496
Wheeling Jesuit University,West-Virginia,44800,83400,57,5,Private,4 Year,9900,29290,39190,29290,39190
University of Charleston,West-Virginia,44600,81900,51,4,Private,4 Year,9180,30900,40080,30900,40080
Marshall University,West-Virginia,45000,79700,50,12,Public,4 Year,10450,8128,18578,18614,29064
West Liberty University,West-Virginia,42500,77000,51,6,Public,4 Year,9406,7730,17136,15670,25076
West Virginia State University,West-Virginia,41800,76000,46,8,Public,4 Year,11892,8167,20059,16072,27964
Concord University,West-Virginia,41700,75800,53,9,Public,4 Year,8988,7896,16884,17320,26308
Fairmont State University,West-Virginia,42900,74100,53,7,Public,4 Year,9004,7514,16518,16324,25328
Ohio Valley University,West-Virginia,38800,71100,81,1,Private,4 Year,7980,21900,29880,21900,29880
Milwaukee School of Engineering,Wisconsin,65700,117600,50,69,Private,4 Year,10389,40749,51138,40749,51138
Marquette University,Wisconsin,57800,105900,52,25,Private,4 Year,12720,41870,54590,41870,54590
University of Wisconsin-Madison,Wisconsin,57300,104400,48,33,Public,4 Year,11114,10555,21669,36805,47919
University of Wisconsin-Platteville,Wisconsin,56800,100300,50,38,Public,4 Year,7580,7571,15151,15421,23001
Lawrence University,Wisconsin,51500,98800,58,25,Private,4 Year,10341,47475,57816,47475,57816
Bellin College,Wisconsin,55800,97600,94,0,Private,4 Year,8830,50040,58870,50040,58870
University of Wisconsin-Eau Claire,Wisconsin,52100,93600,46,14,Public,4 Year,7813,8820,16633,17096,24909
University of Wisconsin-Milwaukee,Wisconsin,50600,90300,50,17,Public,4 Year,10728,11084,21812,22364,33092
Ripon College,Wisconsin,46300,89600,60,26,Private,4 Year,8400,43808,52208,43808,52208
University of Wisconsin-Stout,Wisconsin,50400,89500,47,14,Public,4 Year,6924,9457,16381,17423,24347
University of Wisconsin-Whitewater,Wisconsin,48900,89300,44,8,Public,4 Year,6786,7692,14478,16265,23051
University of Wisconsin-La Crosse,Wisconsin,49600,88300,53,19,Public,4 Year,6331,9106,15437,17924,24255
Edgewood College,Wisconsin,49500,87500,54,5,Private,4 Year,11020,29500,40520,29500,40520
Carroll University,Wisconsin,45600,86500,49,14,Private,4 Year,9484,31918,41402,31918,41402
Beloit College,Wisconsin,47400,85700,59,24,Private,4 Year,8830,50040,58870,50040,58870
Carthage College,Wisconsin,48900,85400,48,17,Private,4 Year,11990,43550,55540,43550,55540
University of Wisconsin-Oshkosh,Wisconsin,47700,84300,52,10,Public,4 Year,7448,8820,16268,16393,23841
Cardinal Stritch University,Wisconsin,47000,82500,51,2,Private,4 Year,8440,29998,38438,29998,38438
Wisconsin Lutheran College,Wisconsin,46200,82500,45,10,Private,4 Year,10190,29725,39915,29725,39915
Viterbo University,Wisconsin,46800,81900,62,3,Private,4 Year,9060,27970,37030,27970,37030
Concordia University-Wisconsin,Wisconsin,46700,81600,61,9,Private,4 Year,10860,29450,40310,29450,40310
University of Wisconsin-Parkside,Wisconsin,46000,81400,47,17,Public,4 Year,8026,7529,15555,15518,23544
University of Wisconsin-River Falls,Wisconsin,47100,81300,52,14,Public,4 Year,6513,7862,14375,15435,21948
University of Wyoming,Wyoming,52400,98800,58,25,Public,4 Year,10320,5400,15720,17490,27810
